
-----------------------------------------------
all-fields
-----------------------------------------------
addressType	i
agentEmail	s
agentName	t
agentPhone	s
apartmentNumber	s
apn	s
broker	t
city	s
cityDisplay	s
cityState	s
county	s
dateListed	s
datePushed	s
dateSold	s
displayLogo	i
displayName	s
forclosureType	s
geoCodeType	s
hasComps	i
impressions	i
key	s
keyword	
landingPageURL	s
latitude	f
listingType	i
longDescription	t
longitude	f
lotSize	f
mlsId	s
neighborhood	s
neighborhoodId	i
numberOfBathrooms	f
numberOfBedrooms	i
oh	s
ohDay1	s
ohDay2	s
ohDay3	s
ohEnd1	s
ohEnd2	s
ohEnd3	s
ohStart1	s
ohStart2	s
ohStart3	s
openHomesDay	s
page_number	i
page_size	i
picturePath	s
pictures	m
pr	s
prevPriceDate	s
prevPriceDolChge	i
price	i
propertyId	s
propertyType	s
ranking	i
siteId	i
siteURL	s
sort_asc	s
sort_desc	s
squareFeet	i
state	s
status	s
street	s
streetDisplay	s
streetNumber	s
type	s
yearBuilt	i
zipCode	s
